fi	ğŸ‘¤ğŸ‘ˆ
self	ğŸ‘¤
thanks	ğŸ™
with	â•ğŸ¤
how	â“ğŸ¤”
what	â“ğŸ“¦
in	â¬…ï¸
name	ğŸ“›
it is	ğŸ‘‰â¡ï¸ğŸ“¦ 
also	ğŸŸ°
bye	ğŸ‘‹
then	â­ï¸ğŸ•’ï¸
see you	ğŸ‘€
soon	ğŸ•’
with	â•ğŸ‘¤
beth	â•ğŸ‘¤
diolch	â•ğŸ‘¤
ef	â•ğŸ‘¤
enw	â•ğŸ‘¤
fuan	â•ğŸ‘¤
gael_cwrdd	â•ğŸ‘¤
thi	â•ğŸ‘¤
mae	â•ğŸ‘¤
yn	â•ğŸ‘¤
neis	â•ğŸ‘¤
a^	â•ğŸ‘¤
hefyd	â•ğŸ‘¤
hwyl	â•ğŸ‘¤
te	â•ğŸ‘¤
welaxx	â•ğŸ‘¤
fyxx	â•ğŸ‘¤
iawnxx	â•ğŸ‘¤
sutxx	â•ğŸ‘¤
wytxx	â•ğŸ‘¤
ywxx	â•ğŸ‘¤
fyxx	â•ğŸ‘¤
a^	â•ğŸ‘¤


